25.ox
...o............o........
...o.o.o..o.o...........o
......o.o.o.......o......
...o..............ooo....
..oo.......o.o...o..o....
.o....o.......o.........o
o.o.o.o..o.o..o.o..o..o..
.o...............o.o.....
......o..o...oo..........
..o......o.....oo..o.o...
o........oooo.o..........
........o..oo..o..o.o....
..............oo.o....o..
..........o..........o...
.........oo...o......o...
..oo.o...o.....o.....o.o.
.o..o......oo....o...oo.o
.......o....o..oo.oo.oooo
...o...........o..o......
o........oo.......o.o....
...oo..o.o............o..
oo......o...........o....
...o.o............o....o.
........o.o......o......o
o......o.....o........o..
